00500093
00500113
00700193
00308663
00100213
00208663
06300293
06200313
00200393
00209463
00300413
00309663
06100493
06000513
00400593
00100073
