00100093
00200113
00300193
00400213
000002b3
40000333
000043b3
00006433
000074b3
00f04513
05506593
00f07613
00100073
