00500093
00108133
001101b3
00718213
002202b3
40128333
002343b3
0033e433
004474b3
00f4c513
05556593
00f5f613
00100073
